软件名称 - 功能描述
----------------------------------------------------------------------------
AccessChk - 查看文件、注册表键、服务、进程、内核对象等的有效权限的命令行工具。
AccessEnum - 显示系统中哪些用户对目录、文件和注册表键具有哪些访问权限的安全工具。
AdExplorer - 高级Active Directory（AD）查看器和编辑器。
AdInsight - 用于故障排除Active Directory客户端应用程序的LDAP（轻量级目录访问协议）实时监视工具。
AdRestore - 恢复Server 2003 Active Directory对象。
Autologon - 绕过登录屏幕的密码屏幕。
Autoruns - 查看系统启动时自动启动的程序，并显示应用程序可以配置自动启动设置的所有注册表和文件位置。
BgInfo - 可完全配置的程序，自动生成包括有关系统的重要信息（包括IP地址、计算机名称、网络适配器等）的桌面背景。
CacheSet - 使用NT提供的函数控制Cache Manager的工作集大小的程序。它与所有版本的NT兼容。
ClockRes - 查看系统时钟的分辨率，也是最大计时器分辨率。
Contig - 希望能够快速地对常用文件进行碎片整理吗？使用Contig来优化单个文件，或创建连续的新文件。
Coreinfo - 显示逻辑处理器和物理处理器、NUMA节点和套接字之间的映射，以及分配给每个逻辑处理器的缓存的新命令行实用程序。
Ctrl2cap - 这是一个内核模式驱动程序，演示了在键盘类驱动程序之上进行键盘输入过滤以将大写锁定键转换为控制键。在这个级别进行过滤允许在NT甚至“看到”它们之前转换和隐藏键。Ctrl2cap还展示了如何使用NtDisplayString()将消息打印到初始化蓝屏幕上。
DebugView - Sysinternals的另一个首创：此程序拦截设备驱动程序调用DbgPrint和Win32程序调用OutputDebugString。它允许在本地计算机或互联网上查看和记录调试会话输出，而无需活动调试器。
Desktops - 此新实用程序使您可以创建多达四个虚拟桌面，并使用托盘界面或热键预览每个桌面上的内容，并轻松在它们之间切换。
Disk2vhd - 简化将物理系统迁移到虚拟机（p2v）的工具。
DiskExt - 显示卷磁盘映射。
Diskmon - 此实用程序捕获所有硬盘活动，或在系统托盘中充当软件磁盘活动指示灯。
DiskView - 图形磁盘扇区实用程序。
Disk Usage (DU) - 按目录查看磁盘使用情况。
EFSDump - 查看加密文件的信息。
Handle - 显示由哪些进程打开了哪些文件，以及更多信息的便捷命令行实用程序。
Hex2dec - 将十六进制数转换为十进制数，反之亦然。
Junction - 创建Win2K NTFS符号链接。
LDMDump - 转储逻辑磁盘管理器的磁盘数据库内容，该数据库描述了Windows 2000动态磁盘的分区。
ListDLLs - 列出当前加载的所有DLL，包括它们加载的位置和版本号。版本2.0打印已加载模块的完整路径名。
LiveKd - 使用Microsoft内核调试器检查活动系统。
LoadOrder - 查看WinNT/2K系统上加载设备的顺序。
LogonSessions - 列出系统上活动登录会话。
MoveFile - 允许您安排下一次重新启动时移动和删除命令。
NTFSInfo - 使用NTFSInfo查看有关NTFS卷的详细信息，包括主文件表（MFT）和MFT区域的大小和位置，以及NTFS元数据文件的大小。
PageDefrag - 碎片整理页面文件和注册表文件。
PendMoves - 枚举下一个引导将执行的文件重命名和删除命令列表。
PipeList - 显示系统上的命名管道，包括每个管道的最大实例数和活动实例数。
PortMon - 使用此高级监视工具监视串行和并行端口活动。它了解所有标准串行和并行IOCTL，并甚至显示正在发送和接收的数据部分。版本3.x具有强大的新UI增强功能和高级过滤功能。
ProcDump - 旨在捕获难以隔离和重现CPU峰值的进程转储的新命令行实用程序。它还可作为一般进程转储创建实用程序，并且当进程具有挂起窗口或未处理异常时，还可以监视和生成进程转储。
Process Explorer - 查找进程打开了哪些文件、注册表键和其他对象、它们加载了哪些DLL等等。这个独特强大的实用程序甚至会向您显示每个进程的所有者。
Process Monitor - 实时监视文件系统、注册表、进程、线程和DLL活动。
ProcFeatures - 此应用程序报告物理地址扩展和无执行缓冲区保护的处理器和Windows支持情况。
PsExec - 在远程系统上执行进程。
PsFile - 查看远程打开了哪些文件。
PsGetSid - 显示计算机或用户的SID。
PsInfo - 获取有关系统的信息。
PsKill - 终止本地或远程进程。
PsList - 显示有关进程和线程的信息。
PsLoggedOn - 显示登录到系统上的用户。
PsLogList - 转储事件日志记录。
PsPasswd - 更改帐户密码。
PsService - 查看和控制服务。
PsShutdown - 关闭计算机并可选地重新启动计算机。
PsSuspend - 暂停和恢复进程。
RAMMap - 高级物理内存使用情况分析工具，在其几个不同选项卡上以不同方式呈现使用情况信息。
RegDelNull - 扫描并删除包含嵌入式空字符且无法通过标准注册表编辑工具进行删除的注册表键。
RegJump - 在Regedit中跳转到您指定的注册表路径。
RootkitRevealer - 扫描系统以查找基于rootkit的恶意软件。
SDelete - 使用此符合DoD标准的安全删除程序，安全地覆盖您的敏感文件并清理先前删除的文件的空闲空间。
ShareEnum - 扫描网络上的文件共享并查看它们的安全设置以关闭安全漏洞。
ShellRunas - 通过方便的Shell上下文菜单条目以不同的用户身份启动程序。
Sigcheck - 转储文件版本信息并验证系统上的映像是否经过数字签名。
Streams - 显示NTFS备用流。
Strings - 在二进制映像中搜索ANSI和UNICODE字符串。
Sync - 将缓存数据刷新到磁盘。
TCPView - 活动套接字命令行查看器。
VMMap - VMMap是一种处理器虚拟和物理内存分析实用程序。
VolumeId - 设置FAT或NTFS驱动器的卷ID。
Whois - 查看谁拥有一个Internet地址。
WinObj - 最终的对象管理器命名空间查看器在这里。
ZoomIt - 用于屏幕缩放和绘图的演示实用程序。